حتمن	حتما
اصلن	اصلا
قطعن	قطعا
رسمن	رسما
احیانن	احیانا
اولن	اولا
کلن	کلا
کاملن	کاملا
ظاهرن	ظاهرا
قاعدتن	قاعدتا
تمامن	تماما
عمرن	عمرا
اتفاقن	اتفاقا
اخیرن	اخیرا
جدیدن	جدیدا
مطلقن	مطلقا
اجبارن	اجبارا
اساسن	اساسا
احتمالن	احتمالا
ذاتن	ذاتا
