رفت	رفتم
گفت	گفتم
دید	دیدم
شنید	شنیدم
خندید	خندیدم
رقصید	رقصیدم
نالید	نالیدم
نوشت	نوشتم
خرید	خریدم
دوید	دویدم
رسید	رسیدم
برید	بریدم
گذشت	گذشتم
نشست	نشستم
امد	امدم
کرد	کردم
شد	شدم
شست	شستم
پوشید	پوشیدم
خواست	خواستم
خواند	خواندم
گشت	گشتم
پرید	پریدم
ترسید	ترسیدم
افتاد	افتادم
خوابید	خوابیدم
پخت	پختم
سوخت	سوختم
ماند	ماندم
بود	بودم
داشت	داشتم
داد	دادم
اموخت	اموختم
جنگید	جنگیدم
سنجید	سنجید
کشید	کشیدم
پرداخت	پرداختم
ساخت	ساختم
دوخت	دوختم
ریخت	ریختم