اتن	یونان
بغداد	عراق
تهران	ایران
کابل	افغانستان
دوشنبه	تاجیکستان
انکارا	ترکیه
کویت	کویت
دهلی	هند
ایروان	ارمنستان
باکو	اذربایجان
استکهلم	سوید
پکن	چین
پاریس	فرانسه
برلین	المان
مادرید	اسپانیا
مسکو	روسیه
دمشق	سوریه
قاهره	مصر
برن	سوییس
لندن	انگلیس
رم	ایتالیا
کانبرا	استرالیا
توکیو	ژاپن
واشنگتن	امریکا
تفلیس	گرجستان
هاوانا	کوبا
کاراکاس	ونزویلا
اتاوا	کانادا
صنعا	یمن
کپنهاگ	دانمارک
لیسبون	پرتغال
کیف	اکراین
دوحه	قطر
ریاض	عربستان
ورشو	لهستان
بلگراد	صربستان
بانکوک	تایلند