کنند	کنن
دارد	داره
اگر	اگه
دیگر	دیگه
هستند	هستن
به	ب
کردند	کردن
ان	اون
او	اون
شود	شه
نشود	نشه
شدند	شدن
باشد	باشه
کند	کنه
تواند	تونه
دادند	دادن
باشند	یاشن
بشود	بشه
جوان	جوون
مثل	مث
ندارد	نداره
دارند	دارن
کسانی	کسایی
گرفتند	گرفتن
دادند	دادن
شود	شه
چیست	چیه
رفتند	رفتن
است	ست
مگر	مگه
است	ه
شدید	شدین
خودشان	خودشون
تمام	تموم
بگوید	بگه
گیرند	گیرن
توانست	تونست
امده	اومده
ایرانیان	ایرانیا
خیابان	خیابون
تومان	تومن
