چاق	لاغر
زشت	زیبا
خارج	داخل
دم	بازدم
خرید	فروش
پر	خالی
سنگین	سبک
پیر	جوان
دیر	زود
خوب	بد
زرنگ	تنبل
فقیر	پولدار
بیمار	سالم
مرده	زنده
بزرگ	کوچک
بلند	کوتاه
سیاه	سفید
کثیف	تمیز
ساده	پیچیده
بدمزه	خوشمزه
سرد	گرم
ناراحت	خوشحال
نااگاه	اگاه
ناامید	امیدوار
گریان	خندان
ازل	ابد
کم	زیاد
رکود	رونق
رفتن	امدن
عشق	نفرت
دروغگو	راستگو
ایاب	ذهاب
اباد	خراب
خوشبخت	بدبخت