کتابا	کتاب	ها
معلما	معلم	ها
دانشگاها	دانشگاه	ها
مادرا	مادر	ها
پدرا	پدر	ها
درختا	درخت	ها
جنگلا	جنگل	ها
پارکا	پارک	ها
ماشینا	ماشین	ها
دخترا	دختر	ها
زنا	زن	ها
مردا	مرد	ها
پسرا	پسر	ها
رستورانا	رستوران	ها
براندازم	برانداز	هستم
موافقم	موافق	هستم
مخالفم	مخالف	هستم
کارمندم	کارمند	هستم
شادیا	شاد	هستی	ها
داغونیا	داغون	هستی	ها
چاکریم	چاکر	هستیم
مخلصیم	مخلص	هستیم
بهتره	بهتر	است
کافیه	کافی	است
لازمه	لازم	است
میان	می	ایند
مرا	من	را
دلارو	دلار	را
ایرانو	ایران	را
دانشگاهو	دانشگاه	را