دو	دوم
سه	سوم
چهار	چهارم
پنج	پنجم
شش	ششم
هفت	هفتم
هشت	هشتم
نه	نهم
ده	دهم
یازده	یازدهم
دوازده	دوازدهم
سیزده	سیزدهم
چهارده	چهاردهم
پانزده	پانزدهم
شانزده	شانزدهم
هفده	هفدهم
هجده	هجدهم
نوزده	نوزدهم
بیست	بیستم
چهل	چهلم
پنجاه	پنجاهم
شصت	شصتم
هفتاد	هفتادم
هشتاد	هشتادم
نود	نودم
صد	صدم